1,1,0,0,0,0,0,0,1,1
1,0,0,0,5,0,0,1,1,1
0,0,5,6,6,1,1,1,1,0
0,0,0,10,0,1,1,1,0,0
0,0,0,0,0,0,1,1,0,0
0,0,1,0,5,0,10,5,0,0
1,1,6,6,0,0,0,0,0,1
1,1,0,0,0,0,0,0,1,1
