1,1,0,0,0,0,0,0,1,1
1,0,6,0,0,0,0,6,0,1
0,0,0,1,1,1,0,0,0,0
0,0,0,1,4,1,1,0,0,0
0,0,0,1,10,5,1,0,0,0
0,0,5,0,5,0,5,0,0,0
1,0,0,0,0,0,0,0,0,1
1,1,0,0,0,0,0,0,1,1
