1,1,0,0,0,0,0,0,1,1
1,0,7,10,10,0,10,0,0,1
0,0,11,0,0,1,8,0,5,0
0,0,8,10,0,0,0,11,5,0
0,0,0,0,0,8,0,0,5,0
0,0,10,1,0,7,0,0,0,0
1,0,0,0,5,5,0,0,1,1
1,1,0,0,0,0,0,0,1,1
