1,1,0,0,0,0,0,0,1,1
1,0,0,1,1,10,6,5,0,1
0,0,1,9,0,9,0,0,0,0
0,1,1,0,1,1,1,0,5,0
0,1,1,0,1,1,1,0,0,0
0,0,0,0,0,0,6,0,0,0
1,0,6,0,5,0,0,5,0,1
1,1,0,0,0,0,10,0,1,1
