1,1,0,0,0,0,0,0,1,1
1,0,7,10,10,0,10,0,0,1
0,0,7,0,0,1,0,0,5,0
0,0,1,1,1,0,0,0,5,0
0,7,7,4,0,7,0,0,5,0
0,0,1,1,0,7,0,10,5,0
1,0,0,0,7,0,0,0,0,1
1,1,0,0,0,0,0,0,1,1
